00 00 00 00 00 00 00 00 00 00 00 00 00 00 00 00 00 00 00 00 00 00 00 00 00 00 00 00 00 00 00 00 00 00 00 00 00 00 00 00 00 00 00 00 00 00 00 00
00 00 00 00 00 00 00 00 00 00 00 00 00 00 00 00 00 00 00 00 00 00 00 00 00 00 00 00 00 00 00 00 00 00 00 00 00 00 00 00 00 00 00 00 00 00 00 00
00 00 00 00 00 00 00 00 00 00 00 00 00 00 00 00 00 00 00 00 00 00 00 00 00 00 00 00 00 00 00 00 00 00 00 00 00 00 00 00 00 00 00 00 00 00 00 00
00 00 00 00 00 00 00 00 00 00 00 00 00 00 00 00 00 00 00 00 00 00 00 00 00 00 00 00 00 00 00 00 00 00 00 00 00 00 00 00 00 00 00 00 00 00 00 00
00 00 00 00 00 00 00 00 00 00 00 00 00 00 00 00 00 00 00 00 00 00 00 00 00 00 00 00 00 00 00 00 00 00 00 00 00 00 00 00 00 00 00 00 00 00 00 00
00 00 00 00 00 00 00 00 00 00 00 00 00 00 00 00 00 00 00 00 00 00 00 00 00 00 00 00 00 00 00 00 00 00 00 00 00 00 00 00 00 00 00 00 00 00 00 00
00 00 00 00 00 00 00 00 00 00 00 00 00 00 12 12 14 14 14 14 14 14 14 14 14 14 14 14 14 14 14 14 00 00 00 00 00 00 00 00 00 00 00 00 00 00 00 00
00 00 00 00 00 00 00 00 01 12 12 17 17 17 12 09 09 09 09 09 09 09 10 05 05 05 05 05 05 05 05 05 18 00 00 00 00 00 00 00 00 00 00 00 00 00 00 00
00 00 00 00 00 00 00 00 18 05 05 05 05 05 12 12 12 12 12 12 12 12 12 05 05 05 05 05 05 05 05 05 18 00 00 00 00 00 00 00 00 00 00 00 00 00 00 00
00 00 00 00 00 00 00 00 18 05 05 05 05 05 05 05 05 05 05 05 05 22 22 05 05 05 05 05 05 05 05 05 18 05 00 00 00 00 00 00 00 00 00 00 00 00 00 00
00 00 00 00 00 00 00 01 18 05 05 05 05 05 05 05 05 05 05 05 05 22 22 05 05 05 05 05 05 05 05 05 18 05 00 00 00 00 00 00 00 00 00 00 00 00 00 00
00 00 00 00 00 00 00 01 18 05 05 05 05 05 05 05 05 05 05 05 05 22 22 05 05 05 05 05 05 05 05 05 18 00 00 00 00 00 00 00 00 00 00 00 00 00 00 00
00 00 00 00 00 00 00 00 18 05 05 05 05 05 05 05 05 05 05 05 05 22 22 05 26 05 05 26 05 05 26 05 18 00 00 00 00 00 00 00 00 00 00 00 00 00 00 00
00 00 00 00 00 00 00 00 12 08 13 02 02 02 02 02 02 02 13 16 16 16 16 16 13 16 16 16 16 16 16 16 13 12 12 12 12 12 13 00 00 00 00 00 00 00 00 00
00 00 00 00 00 00 00 00 12 07 19 13 02 02 02 02 02 02 02 13 06 06 06 06 06 06 06 06 06 27 01 01 01 03 03 01 01 01 18 00 00 00 00 00 00 00 00 00
00 00 00 00 00 00 00 00 12 07 19 06 13 02 13 02 02 02 02 02 13 06 06 06 06 06 06 06 06 27 01 01 03 03 03 03 01 01 18 00 00 00 00 00 00 00 00 00
00 00 00 00 00 00 00 00 12 07 19 06 06 13 20 13 02 02 02 02 02 13 06 06 06 06 06 11 06 27 01 03 03 03 03 03 03 01 18 00 00 00 00 00 00 00 00 00
00 00 00 00 00 00 00 00 12 07 19 06 06 06 20 20 13 02 02 02 02 02 13 06 06 06 11 02 11 27 01 01 03 03 03 03 01 01 18 00 00 00 00 00 00 00 00 00
00 00 00 00 00 00 00 00 12 07 19 06 06 06 06 13 02 02 02 02 02 02 02 11 06 11 02 02 02 11 01 13 01 03 03 01 01 01 01 00 00 00 00 00 00 00 00 00
00 00 00 00 00 00 00 00 12 07 19 06 20 20 06 06 13 02 02 02 02 02 02 24 11 23 02 02 11 23 23 01 01 01 01 01 01 01 18 00 00 00 00 00 00 00 00 00
00 00 00 00 00 00 00 00 12 07 19 06 20 20 06 06 06 13 02 02 02 02 24 24 24 04 23 11 23 23 23 23 01 01 01 01 01 01 18 00 00 00 00 00 00 00 00 00
00 00 00 00 00 00 00 00 12 07 19 06 06 06 06 06 06 06 13 02 02 24 24 24 04 04 04 23 23 23 23 23 23 03 03 01 01 01 18 00 00 00 00 00 00 00 00 00
00 00 00 00 00 00 00 00 12 07 19 06 06 06 06 06 06 06 06 13 24 24 24 04 04 04 04 04 23 23 23 23 23 23 03 03 01 01 15 00 00 00 00 00 00 00 00 00
00 00 00 00 00 00 00 00 12 07 20 06 06 06 06 06 06 06 06 13 24 24 04 04 04 04 04 04 24 24 24 24 24 24 03 03 03 01 15 00 00 00 00 00 00 00 00 00
00 00 00 00 00 00 00 00 12 07 19 06 06 06 06 06 06 06 06 12 24 04 04 04 04 04 04 24 24 24 24 24 24 03 03 03 01 01 15 00 00 00 00 00 00 00 00 00
00 00 00 00 00 00 00 00 12 07 19 06 06 06 06 06 06 06 12 12 12 25 04 04 04 04 24 11 24 24 24 24 01 03 03 01 01 01 15 00 00 00 00 00 00 00 00 00
00 00 00 00 00 00 00 00 12 07 19 06 06 06 06 06 06 12 12 12 12 12 04 04 04 24 02 02 11 24 24 01 01 01 01 01 01 01 15 00 00 00 00 00 00 00 00 00
00 00 00 00 00 00 00 00 12 07 19 06 06 06 06 06 06 06 12 12 12 23 23 23 23 11 02 02 02 11 01 01 01 01 01 01 01 01 15 00 00 00 00 00 00 00 00 00
00 00 00 00 00 00 00 00 12 07 19 06 06 06 06 06 06 06 06 12 23 23 23 23 19 19 11 02 11 06 01 01 01 01 01 01 01 01 15 00 00 00 00 00 00 00 00 00
00 00 00 00 00 00 00 00 12 18 06 06 06 06 06 06 06 06 06 02 02 02 02 02 06 06 06 11 06 06 01 01 01 01 01 01 01 01 28 00 00 00 00 00 00 00 00 00
00 00 00 00 00 00 00 00 12 18 06 06 06 06 06 06 06 06 06 02 02 02 02 02 06 06 06 06 06 06 01 01 01 03 03 01 01 01 28 00 00 00 00 00 00 00 00 00
00 00 00 00 00 00 00 00 12 18 06 06 20 20 06 06 06 06 06 02 02 02 02 02 06 06 06 06 06 06 01 01 03 03 03 03 01 01 15 00 00 00 00 00 00 00 00 00
00 00 00 00 00 00 00 00 12 18 06 06 20 20 06 06 06 06 06 02 02 02 02 02 06 06 06 06 06 06 01 03 03 03 03 03 03 01 15 00 00 00 00 00 00 00 00 00
00 00 00 00 00 00 00 00 12 18 06 06 06 06 06 06 06 06 06 21 21 21 21 21 06 06 06 06 06 06 01 01 03 03 03 03 01 01 15 00 00 00 00 00 00 00 00 00
00 00 00 00 00 00 00 00 12 18 06 06 06 06 06 06 06 06 06 02 02 02 02 02 02 02 02 02 02 02 01 01 01 03 03 01 01 01 15 00 00 00 00 00 00 00 00 00
00 00 00 00 00 00 00 00 18 06 06 06 06 06 06 06 06 06 06 02 02 02 02 02 06 06 06 06 06 06 12 14 14 14 14 14 14 14 00 00 00 00 00 00 00 00 00 00
00 00 00 00 00 00 00 00 18 06 06 06 20 06 06 06 06 06 06 02 02 02 02 02 06 06 06 06 06 06 12 00 00 00 00 00 00 00 00 00 00 00 00 00 00 00 00 00
00 00 00 00 00 00 00 00 18 06 06 06 20 06 06 06 06 06 06 02 02 02 02 02 06 06 06 06 06 06 12 00 00 00 00 00 00 00 00 00 00 00 00 00 00 00 00 00
00 00 00 00 00 00 00 00 18 06 06 06 06 06 06 06 06 06 06 02 02 02 02 02 06 06 06 06 06 06 12 00 00 00 00 00 00 00 00 00 00 00 00 00 00 00 00 00
00 00 00 00 00 00 00 00 18 20 06 06 06 06 06 06 06 06 06 02 02 02 02 02 06 06 06 06 06 06 12 00 00 00 00 00 00 00 00 00 00 00 00 00 00 00 00 00
00 00 00 00 00 00 00 00 18 06 06 06 06 06 06 06 06 06 06 02 02 02 02 02 06 06 06 06 06 06 12 00 00 00 00 00 00 00 00 00 00 00 00 00 00 00 00 00
00 00 00 00 00 00 00 00 18 06 06 06 06 06 06 06 06 06 06 02 02 02 02 02 06 06 06 06 06 06 12 00 00 00 00 00 00 00 00 00 00 00 00 00 00 00 00 00
00 00 00 00 00 00 00 00 17 17 17 17 17 17 17 17 17 17 17 17 17 17 17 17 17 17 17 17 17 17 17 00 00 00 00 00 00 00 00 00 00 00 00 00 00 00 00 00
00 00 00 00 00 00 00 00 00 00 00 00 00 00 00 00 00 00 00 01 01 01 01 01 00 00 00 00 00 00 00 00 00 00 00 00 00 00 00 00 00 00 00 00 00 00 00 00
00 00 00 00 00 00 00 00 00 00 00 00 00 00 00 00 00 00 00 00 00 00 00 00 00 00 00 00 00 00 00 00 00 00 00 00 00 00 00 00 00 00 00 00 00 00 00 00
00 00 00 00 00 00 00 00 00 00 00 00 00 00 00 00 00 00 00 00 00 00 00 00 00 00 00 00 00 00 00 00 00 00 00 00 00 00 00 00 00 00 00 00 00 00 00 00
00 00 00 00 00 00 00 00 00 00 00 00 00 00 00 00 00 00 00 00 00 00 00 00 00 00 00 00 00 00 00 00 00 00 00 00 00 00 00 00 00 00 00 00 00 00 00 00
00 00 00 00 00 00 00 00 00 00 00 00 00 00 00 00 00 00 00 00 00 00 00 00 00 00 00 00 00 00 00 00 00 00 00 00 00 00 00 00 00 00 00 00 00 00 00 00
00 00 00 00 00 00 00 00 00 00 00 00 00 00 00 00 00 00 00 00 00 00 00 00 00 00 00 00 00 00 00 00 00 00 00 00 00 00 00 00 00 00 00 00 00 00 00 00
00 00 00 00 00 00 00 00 00 00 00 00 00 00 00 00 00 00 00 00 00 00 00 00 00 00 00 00 00 00 00 00 00 00 00 00 00 00 00 00 00 00 00 00 00 00 00 00 