00 00 00 00 00 00 00 00 00 00 00 00 00 00 00 00 00 00 00 00 00 00 00 00 00 00 00 00 00 00 00 00 00 00 00 00 00 00 00 00 00 00 00 00 00 00 00 00 00 00 00
00 00 00 00 00 00 00 00 00 00 00 00 00 00 00 00 00 00 00 00 00 00 00 00 00 00 00 00 00 00 00 00 00 00 00 00 00 00 00 00 00 00 00 00 00 00 00 00 00 00 00
00 00 00 00 00 00 00 00 00 00 00 00 00 00 00 00 00 00 00 00 00 00 00 00 00 00 00 00 00 00 00 00 00 00 00 00 00 00 00 00 00 00 00 00 00 00 00 00 00 00 00
00 00 00 00 00 00 00 00 00 00 00 00 00 00 00 00 00 00 00 00 00 00 00 00 00 00 00 00 00 00 00 00 00 00 00 00 00 00 00 00 00 00 00 00 00 00 00 00 00 00 00
00 00 00 00 00 00 00 00 00 00 00 00 00 00 00 00 00 00 00 00 00 00 00 00 00 00 00 00 00 00 00 00 00 00 00 00 00 00 00 00 00 00 00 00 00 00 00 00 00 00 00
00 00 00 00 00 00 00 00 00 00 00 00 00 00 00 00 00 00 00 00 00 00 00 00 00 00 00 00 00 00 00 00 00 00 00 00 00 00 00 00 00 00 00 00 00 00 00 00 00 00 00
00 00 00 00 00 00 00 00 00 00 00 00 00 00 00 00 00 00 00 00 00 00 00 00 00 00 00 00 00 00 00 00 00 00 00 00 00 00 00 00 00 00 00 00 00 00 00 00 00 00 00
00 00 00 00 00 00 00 00 00 00 00 13 13 13 13 13 13 13 13 13 13 13 13 00 00 00 00 00 00 00 00 00 00 00 00 00 00 00 00 00 00 00 00 00 00 00 00 00 00 00 00
00 00 00 00 00 00 00 00 00 00 00 36 21 21 21 36 02 02 02 02 02 02 13 00 00 00 00 00 00 00 00 00 00 00 00 00 00 00 00 00 00 00 00 00 00 00 00 00 00 00 00
00 00 00 00 00 00 00 00 12 36 36 36 21 21 21 24 02 02 02 02 02 02 13 00 00 00 00 00 00 00 00 00 00 00 00 00 00 00 00 00 00 00 00 00 00 00 00 00 00 00 00
00 00 00 00 00 00 00 00 12 02 02 22 02 02 02 02 02 02 02 02 02 02 13 00 00 00 00 00 00 00 00 00 00 00 00 00 00 00 00 00 00 00 00 00 00 00 00 00 00 00 00
00 00 00 00 00 00 00 00 12 02 02 22 02 02 02 13 02 02 02 02 02 02 13 13 13 13 13 13 13 13 00 00 00 00 00 00 00 00 00 00 00 00 00 00 00 00 00 00 00 00 00
00 00 00 00 00 00 00 00 12 02 02 23 21 21 02 02 02 02 02 02 02 02 02 35 35 35 35 35 02 13 00 00 00 00 00 00 00 00 00 00 00 00 00 00 00 00 00 00 00 00 00
00 00 00 00 00 00 00 00 12 02 03 03 03 02 22 02 03 03 03 03 03 02 03 03 03 03 03 02 02 13 00 00 00 00 00 12 12 12 12 12 12 12 12 00 00 00 00 00 00 00 00
00 00 00 00 00 00 00 00 12 32 03 03 03 02 22 02 03 03 03 03 03 02 03 03 03 03 03 12 08 13 00 00 00 00 00 12 02 35 35 35 35 02 12 00 00 00 00 00 00 00 00
00 00 00 00 00 00 00 00 12 32 03 03 03 02 22 02 03 03 03 03 03 02 03 03 03 03 03 12 07 13 00 00 00 00 00 12 32 03 03 03 03 30 12 00 00 00 00 00 00 00 00
00 00 00 00 00 00 00 00 12 32 03 03 03 02 22 02 03 03 03 03 03 02 03 03 03 03 03 12 07 13 00 00 00 00 00 12 32 03 03 03 03 30 12 00 00 00 00 00 00 00 00
00 00 00 00 00 00 00 00 12 34 03 03 03 02 22 02 03 03 03 03 03 02 03 03 03 03 03 12 07 13 00 00 00 00 00 12 32 03 03 03 03 30 12 00 00 00 00 00 00 00 00
00 00 00 00 00 00 00 00 12 02 02 12 12 12 12 13 13 13 13 13 13 13 02 02 02 02 02 12 07 13 00 00 00 00 00 12 32 03 03 03 03 30 12 00 00 00 00 00 00 00 00
00 00 00 00 00 00 00 00 12 02 02 10 09 02 12 13 29 29 29 29 29 13 03 03 03 03 03 12 07 13 00 00 00 00 00 12 32 02 02 02 02 02 12 00 00 00 00 00 00 00 00
00 00 00 00 00 00 00 00 12 02 02 12 12 07 12 13 29 29 29 29 29 13 03 03 03 03 03 12 07 13 12 12 12 12 12 13 02 02 02 02 02 02 28 00 00 00 00 00 00 00 00
00 00 00 00 00 00 00 00 12 02 02 03 12 08 12 13 29 29 29 29 29 13 03 03 03 03 03 12 02 09 09 09 09 09 09 10 02 03 03 03 03 30 12 00 00 00 00 00 00 00 00
00 00 00 00 00 00 00 00 13 02 12 12 12 07 12 13 29 29 29 29 29 13 03 03 03 03 03 12 12 12 12 12 12 12 12 12 02 03 03 03 03 30 28 00 00 00 00 00 00 00 00
00 00 00 00 00 00 00 00 18 02 02 02 09 02 12 13 29 29 29 29 29 13 03 03 03 03 03 02 02 02 02 02 33 02 33 02 02 03 03 03 03 30 12 00 00 00 00 00 00 00 00
00 00 00 00 00 00 00 00 18 02 02 02 12 12 12 13 13 13 13 13 13 13 02 02 02 02 02 02 02 02 02 02 33 02 33 02 02 03 03 03 03 30 12 00 00 00 00 00 00 00 00
00 00 00 00 00 00 00 00 18 02 03 03 03 26 03 02 03 03 03 03 03 02 03 03 03 03 03 02 02 02 26 02 33 02 33 25 02 31 31 31 31 02 12 00 00 00 00 00 00 00 00
00 00 00 00 00 00 00 00 01 02 03 03 03 03 03 02 03 03 03 03 03 02 03 03 03 03 03 02 02 13 12 12 12 12 12 37 12 12 12 12 12 12 12 00 00 00 00 00 00 00 00
00 00 00 00 00 00 00 00 18 02 03 03 03 03 03 02 03 03 03 03 03 02 03 03 03 03 03 02 30 13 00 00 00 00 00 00 00 00 00 00 00 00 00 00 00 00 00 00 00 00 00
00 00 00 00 00 00 00 00 18 02 03 03 03 03 03 02 03 03 03 03 03 02 03 03 03 03 03 02 30 13 00 00 00 00 00 00 00 00 00 00 00 00 00 00 00 00 00 00 00 00 00
00 00 00 00 00 00 00 00 18 02 03 03 03 03 03 02 03 03 03 03 03 02 03 03 03 03 03 02 30 13 00 00 00 00 00 00 00 00 00 00 00 00 00 00 00 00 00 00 00 00 00
00 00 00 00 00 00 00 00 15 31 31 31 02 02 02 02 02 02 02 31 31 31 31 02 02 02 02 02 02 13 00 00 00 00 00 00 00 00 00 00 00 00 00 00 00 00 00 00 00 00 00
00 00 00 00 00 00 00 00 15 13 13 13 05 05 05 13 37 37 13 13 13 13 13 13 11 11 11 11 11 13 00 00 00 00 00 00 00 00 00 00 00 00 00 00 00 00 00 00 00 00 00
00 00 00 00 00 00 00 00 00 00 00 13 05 05 05 13 00 00 00 00 00 00 00 34 00 00 00 00 00 00 00 00 00 00 00 00 00 00 00 00 00 00 00 00 00 00 00 00 00 00 00
00 00 00 00 00 00 00 00 00 00 00 13 05 05 05 13 00 00 00 00 00 00 00 00 00 00 00 00 00 00 00 00 00 00 00 00 00 00 00 00 00 00 00 00 00 00 00 00 00 00 00
00 00 00 00 00 00 00 00 00 00 00 13 05 05 05 13 00 00 00 00 00 00 00 00 00 00 00 00 00 00 00 00 00 00 00 00 00 00 00 00 00 00 00 00 00 00 00 00 00 00 00
00 00 00 00 00 00 00 00 00 00 00 13 05 05 05 13 00 00 00 00 00 00 00 00 00 00 00 00 00 00 00 00 00 00 00 00 00 00 00 00 00 00 00 00 00 00 00 00 00 00 00
00 00 00 00 00 00 00 00 00 00 00 13 37 37 13 13 00 00 00 00 00 00 00 00 00 00 00 00 00 00 00 00 00 00 00 00 00 00 00 00 00 00 00 00 00 00 00 00 00 00 00
00 00 00 00 00 00 00 00 00 00 00 00 00 00 00 00 00 00 00 00 00 00 00 00 00 00 00 00 00 00 00 00 00 00 00 00 00 00 00 00 00 00 00 00 00 00 00 00 00 00 00
00 00 00 00 00 00 00 00 00 00 00 00 00 00 00 00 00 00 00 00 00 00 00 00 00 00 00 00 00 00 00 00 00 00 00 00 00 00 00 00 00 00 00 00 00 00 00 00 00 00 00
00 00 00 00 00 00 00 00 00 00 00 00 00 00 00 00 00 00 00 00 00 00 00 00 00 00 00 00 00 00 00 00 00 00 00 00 00 00 00 00 00 00 00 00 00 00 00 00 00 00 00
00 00 00 00 00 00 00 00 00 00 00 00 00 00 00 00 00 00 00 00 00 00 00 00 00 00 00 00 00 00 00 00 00 00 00 00 00 00 00 00 00 00 00 00 00 00 00 00 00 00 00
00 00 00 00 00 00 00 00 00 00 00 00 00 00 00 00 00 00 00 00 00 00 00 00 00 00 00 00 00 00 00 00 00 00 00 00 00 00 00 00 00 00 00 00 00 00 00 00 00 00 00
00 00 00 00 00 00 00 00 00 00 00 00 00 00 00 00 00 00 00 00 00 00 00 00 00 00 00 00 00 00 00 00 00 00 00 00 00 00 00 00 00 00 00 00 00 00 00 00 00 00 00
00 00 00 00 00 00 00 00 00 00 00 00 00 00 00 00 00 00 00 00 00 00 00 00 00 00 00 00 00 00 00 00 00 00 00 00 00 00 00 00 00 00 00 00 00 00 00 00 00 00 00